1111111111
1P000001C1
100C000001
10000001E1
1111111111
