1111111111111111111111111
1P10C010C010C0C010C010C01
1010101010101010101010101
1010101010101010101010101
1010101010101010101010101
1010101010101010101010101
1010101010101010101010101
1010101010101010101010101
1010101010101010101010101
1010101010101010101010101
1010101010101010101010101
1010101010101010101010101
10C010C010C01010C010C01E1
1111111111111111111111111
