111111111111111111111
1C0000000000000000001
100000000000000000001
100000000000000000001
100000000000000000001
1000000000P0000000001
100000000000000000001
100000000000000000001
100000000000000000001
1C00000000000000001E1
111111111111111111111
